route,stops,early,on_time,late,total,early %,on_time %,late %
46,ROCKVILLE PIKE & SOUTH WOOD RD,24,460,72,556,0.04,0.83,0.13
46,ROCKVILLE PIKE & NORTH WOOD DR,25,338,47,410,0.06,0.82,0.11
46,ROCKVILLE PIKE & LOCUST HILL RD,3,22,2,27,0.11,0.81,0.07
46,ROCKVILLE PIKE & BROAD BROOK DR,3,22,2,27,0.11,0.81,0.07
46,ROCKVILLE PIKE & RICHARD MONTGOMERY,36,213,17,266,0.14,0.8,0.06
46,ROCKVILLE PIKE & CEDAR LN,23,122,9,154,0.15,0.79,0.06
46,ROCKVILLE PIKE & OLD GEORGETOWN RD,220,845,64,1129,0.19,0.75,0.06
46,ROCKVILLE PIKE & BELLEVUE DR,20,57,1,78,0.26,0.73,0.01
46,ROCKVILLE PIKE & BOU AVE,391,1315,144,1850,0.21,0.71,0.08
46,MANNAKEE ST & HUNGERFORD DR,15,78,17,110,0.14,0.71,0.15
46,ROCKVILLE PIKE & PIKE CENTER,130,436,45,611,0.21,0.71,0.07
46,ROCKVILLE PIKE & POOKS HILL RD,309,896,77,1282,0.24,0.7,0.06
46,ROCKVILLE PIKE & @1001,269,840,85,1194,0.23,0.7,0.07
46,ROCKVILLE PIKE & HUBBARD DR,154,448,47,649,0.24,0.69,0.07
46,ROCKVILLE PIKE & NICHOLSON LN,238,661,80,979,0.24,0.68,0.08
46,ROCKVILLE PIKE & MT VERNON PL,162,534,88,784,0.21,0.68,0.11
46,ROCKVILLE PIKE & TUCKERMAN LN,646,1679,148,2473,0.26,0.68,0.06
46,N WASHINGTON ST & MARTINS LN,107,420,87,614,0.17,0.68,0.14
46,HUNGERFORD DR & FREDERICK AVE,195,989,268,1452,0.13,0.68,0.18
46,ROCKVILLE PIKE & MARINELLI RD,1222,3082,307,4611,0.27,0.67,0.07
46,ROCKVILLE PIKE & HALPINE RD,599,1608,192,2399,0.25,0.67,0.08
46,ROCKVILLE PIKE & BETH MED PRK DR,95,218,11,324,0.29,0.67,0.03
46,ROCKVILLE PIKE & WOOTTON PKWY,194,557,98,849,0.23,0.66,0.12
46,N WASHINGTON ST & DAWSON AVE,241,722,134,1097,0.22,0.66,0.12
46,ROCKVILLE PIKE & CONGRESSIONAL LN,570,1454,187,2211,0.26,0.66,0.08
46,MANNAKEE ST & CAMPUS DR,12,37,8,57,0.21,0.65,0.14
46,ROCKVILLE PIKE & SECURITY LN,237,529,65,831,0.29,0.64,0.08
46,N WASHINGTON ST & MIDDLE LN,57,145,23,225,0.25,0.64,0.1
46,ROCKVILLE PIKE & EDMONSTON DR,1227,2963,422,4612,0.27,0.64,0.09
46,N WASHINGTON ST & BEALL AVE,137,329,51,517,0.26,0.64,0.1
46,ROCKVILLE PIKE & THOMPSON AVE,115,244,30,389,0.3,0.63,0.08
46,MONROE ST & MONROE PL,355,697,81,1133,0.31,0.62,0.07
46,ROCKVILLE PIKE & FIRST ST,64,157,33,254,0.25,0.62,0.13
46,ROCKVILLE PIKE & TALBOTT ST,244,518,75,837,0.29,0.62,0.09
46,ROCKVILLE PIKE & RANDOLPH RD,627,1355,203,2185,0.29,0.62,0.09
46,ROCKVILLE PIKE & STRATHMORE AVE,51,99,12,162,0.31,0.61,0.07
46,ROCKVILLE PIKE & HOYA ST,249,502,72,823,0.3,0.61,0.09
46,ROCKVILLE PIKE & COUNTRY CLUB RD,46,99,18,163,0.28,0.61,0.11
46,ROCKVILLE PIKE & ROSE AVE,2,3,0,5,0.4,0.6,0.0
46,S WASHINGTON ST & MONTGOMERY AVE,34,74,16,124,0.27,0.6,0.13
46,ROCKVILLE PIKE & ROLLINS AVE,351,650,85,1086,0.32,0.6,0.08
46,ROCKVILLE PIKE & GROSVENOR LN,39,68,6,113,0.35,0.6,0.05
46,ROCKVILLE PIKE & BOUIC AVE,367,698,119,1184,0.31,0.59,0.1
46,ROCKVILLE STATION  & BAY A - WEST,5169,14554,5137,24860,0.21,0.59,0.21
46,ROCKVILLE PIKE & WOODMONT STATION,115,214,34,363,0.32,0.59,0.09
46,ROCKVILLE PIKE & TEMPLETON PL,271,513,97,881,0.31,0.58,0.11
46,ROCKVILLE PIKE & NEW ST,15,36,11,62,0.24,0.58,0.18
46,S CAMPUS DR & CAMPUS DR,1072,5136,2895,9103,0.12,0.56,0.32
46,ROCKVILLE PIKE & NORTH DR,11,18,4,33,0.33,0.55,0.12
46,ROCKVILLE PIKE & EXECUTIVE BLVD,192,296,63,551,0.35,0.54,0.11
46,ROCKVILLE PIKE & FLANDERS AVE,28,37,6,71,0.39,0.52,0.08
46,E JEFFERSON ST & MARYLAND AVE,83,108,15,206,0.4,0.52,0.07
46,HALPINE RD & ROCKVILLE PIKE,19,32,11,62,0.31,0.52,0.18
46,MEDICAL CENTER STATION  & BAY D,6318,19238,12469,38025,0.17,0.51,0.33
46,TWINBROOK STATION  & BAY A - WEST,3828,6813,2603,13244,0.29,0.51,0.2
46,ROCKVILLE PIKE & ALTA VISTA RD,28,30,3,61,0.46,0.49,0.05
46,ROCKVILLE PIKE & GROSVENOR STATION,92,131,42,265,0.35,0.49,0.16
46,ROCKVILLE PIKE & WICKSHIRE WAY,36,33,0,69,0.52,0.48,0.0
46,GROSVENOR STATION  & BAY E,327,368,110,805,0.41,0.46,0.14
46,ROCKVILLE PIKE & HILLERY WAY,21,19,3,43,0.49,0.44,0.07
46,MANNAKEE ST & CAMPUS (E) DR,41,55,30,126,0.33,0.44,0.24
46,ROCKVILLE PIKE & ELSMERE AVE,14,13,3,30,0.47,0.43,0.1
46,CHAPMAN AVE & BOUIC AVE,1,1,1,3,0.33,0.33,0.33
46,S WASHINGTON ST & COURT HOUSE SQ,6,3,2,11,0.55,0.27,0.18
46,TUCKERMAN LN & ROCKVILLE PIKE,6,2,0,8,0.75,0.25,0.0
